



NO ./textures/no.xpm
SO ./textures/so.xpm
EA ./textures/est.xpm
WE ./textures/we.xpm
DO ./textures/we.xpm



C 84,107,171

F 61,43,3



        111111111111111111111111
        1000000000110000000000001
        1011000001110000010000001
        1001000000000000101000021
111111111011000001110000010000001
100000000011000001110111110001111
11110111111111011100000010001
11110011111111111111111111211
11000000110101011100000010001
10000000000000001100000010001
10000000000000001101010010001
11000001110101011111011110N01
11110111 1110101 101111010001
11111111 1111111 111111111111




